width = 5632
height = 2048

max_provinces = 5000

sea_starts = { 
	2 3 5 6 10 12 13 30 31 32 34 35 41 42 43 47 48 49 50 51 52 53 54 55 56 58 59 60 61 63 64 65 66 67 68 69 70 71 72 73 76 77 79 80 81 82 83 85 86 87 88 89 90 91 92 93 94 95 107 110 111 115 116 117 118 122 124 138 140 142 145 146 148 151 160 161 162 163 164 165 166 172 173 175 184 185 186 187 188 189 190 191 192 208 216 217 220 221 224 226 227 229 232 234 236 238 240 243 244 245 251 252 254 255 265 266 267 268 269 272 276 282 283 284 285 286 287 289 290 291 295 297 298 300 302 303 304 306 308 310 311 312 314 316 318 319 322 323 325 327 329 350 351 352 353 354 355 356 357 358 359 372 377 379 380 381 386 387 388 394 398 399 407 409 410 413 414 417 420 421 426 428 429 430 432 441 442 443 486 488 489 493 494 495 498 499 502 503 512 513  551 555 559 566 2081 2082 2083 2084 2085 2087 2088 2089 2090 2091 2092 2093 3720 3721 3727 3728 3729 3735 3869 3870 3871 3873 3874 3875 3876 3877 3878 3882 3884 3885 3886 3887 3889 3890 3891 3892 3893 3894 3895  3897 3898 3901 3961 3965 3966 3967 3969 3970 3972 3975 3976 3977 3978 3979 3983 3987 3988 3989 3990 3992 3994 3995 3996 3997 3998 4000 4001 4005 4006 4007 4010 4016 4019 4022 4026 4028 4029 4030 4031 4032 4033 4034 4035 4036 4038 4047 4048 4049 4050 4051 4052 4053 4054 4055 4213 4214 4215 4219 4224 3579 2920 2921 2922 2923 2924 2925 2926 2927 2928 2929 2930 2931 2932 2933 2934 2935 2936 2937 2938 2939 2940 2941 2942 2943 2944 2945 2946 2947 2948
}

lakes = {
	3514 3515 3516 3517 3518 3519 3520 3521 3522 3523 3524 3525 3526 3527 3528 3529 3530 3531 3532 3533 3534 3535 3536 3537 3538 3539 3540 3541 3542 3543 3544 3545 3546 3547 3548 3549 3550 3551 3552 3553 3554 3555 3556 3557 3558 3559 3560 3561 3562 3563 3564 3565 3566 3567 3568 3569 3570 3571 3572 3573 3576 3577 3578 3580 3581 3582 3583 3584 3585 3586 3587 3588 3589 3590 3591 3592 3593 3594 3595 3596 3597 3598 3599 3600 3601 3602 3603 3604 3605 3606 3607 3608 3609 3610 3611 3612 3613 3614 3615 3616 3617 3618 3619 3620 3621 3622 3623 3624 3625 3626 3627 3628 3629 3630 3631 3632 3633 
    3742 3743 3744 3745 3746 3747 128 147 935 2560 2567 2692 2693 2694 2695 2696 2697 2698 2699 3008 4766
}

only_used_for_random = {
    514 524 532 534 535 549 1173 1174 1175 1176 1183 1184 1186 1187 1188 1189 1190 1191 1192 1193 1194 1196 1197 1198 1199 1201 1204 1205 2210 2983 1177 1180 1171
    
    3046 3087 3088 3089 3090 
    
    3145 3146 3147 3148 3149 3150 3151 3152 3153 3193 3196 3201 3359 3375 3450 3735 3476 3728 3727 3081 3081 3574 3575
    
    4770 4771 4774 4775 4777 
    
    4805 4806 4807 4808 4809 4810 4811 4812 4813 4814 4815 4816 4817 4818 4819 4820 4821 4822 4823 4824 4825 4826 4827 4828 4829 4830 4831 4832 4833 4834 4835 4836 4837 4838 4839 4840 4841 4842 4843 4844 4845 4846 4847 4848 4849 4850 4851 4852 4853 4854 4855 4856 4857 4858 4859 4860 4861 4862 4863 4864 4865 4866 4867 4868 4869 4870 4871 4872 4873 4874 4875 4876 4877 4878 4879 4880 4881 4882 4883 4884 4885 4886 4887 4888 4889 4890 4891 4892 4893 4894 4895 4896 4897 4898 4899 4900 4901 4902 4903 4904 4905 4906 4907 4908 4909 4910 4911 4912 4913 4914 4915 4916 4917 4918 4919 4920 4921 4922 4923 4924 4925 4926 4927 4928 4929 4930 4931 4932 4933 4934 4935 4936 4937 4938 4939 4940 4941 4942 4943 4944 4945 4946 4947 4948 4949 4950 4951 4952 4953 4954 4955 4956 4957 4958 4959 4960 4961 4962 4963 4964 4965 4966 4967 4968 4969 4970 4971 4972 4973 4974 4975 4976 4977 4978 4979 4980 4981 4982 4983 4984 4985 4986 4987 4988 4989 4990 4991 4992 4993 4994 4995 4996 4997 4998 4999 
    
    7 8 9 14 15 16 17 18 19 20 21 22 23 24 25 26 27 28 29 33 36 37 38 39 40 44 45 46 57 74 75 84 96 97 98 99 100 101 102 104 105 106 108 109 112 113 119 120 121 123 125 126 127 129 130 131 132 133 134 135 136 137 149 150 152 153 154 155 156 157 158 159 167 174 176 177 178 183 193 194 195 196 197 198 199 200 201 202 203 204 205 206 207 209 210 211 212 213 214 218 219 222 223 225 228 230 231 233 235 237 239 241 242 248 250 253 256 270 271 273 274 275 288 292 293 294 296 299 301 305 307 309 313 315 317 320 321 324 326 330 331 332 333 334 335 336 337 338 339 340 341 342 343 344 345 346 347 349 369 370 371 373 374 375 376 378 382 383 384 385 389 390 391 392 393 395 396 397 400 401 402 403 404 406 408 411 412 415 418 419 422 423 424 425 427 431 433 434 435 436 437 438 439 440 444 445 446 447 449 450 451 452 453 454 455 456 457 458 459 460 461 462 463 464 465 466 467 468 469 479 485 492 496 2086 2094 2095 2521 3076 3710 3712 3714 3715 3730 3731 3732 3733 3734 3736 3872 3879 3880 3881 3883 3888 3896 3899 3900 3902 3903 3904 3906 3907 3908 3909 3910 3911 3912 3913 3914 3915 3916 3917 3918 3919 3920 3921 3922 3923 3924 3925 3926 3927 3928 3929 3930 3931 3932 3933 3934 3935 3936 3937 3938 3939 3940 3941 3942 3943 3944 3945 3946 3947 3948 3949 3950 3951 3960 3962 3963 3964 3971 3973 3974 3980 3981 3982 3984 3985 3986 3991 3993 3999 4002 4003 4004 4008 4009 4011 4012 4013 4014 4015 4017 4018 4020 4021 4023 4024 4025 4027 4037 4039 4040 4041 4042 4043 4044 4045 4046 4054 4055 4056 4156 4157 4158 4159 4160 4161 4162 4163 4164 4165 4166 4167 4168 4173 4174 4175 4176 4177 4178 4179 4180 4181 4182 4183 4184 4186 4191 4192 4193 4204 4205 4206 4207 4209 4211 4212 4216 4217 4218 4220 4221 4222 4230
    
    470 471 478 484 487 490 491 497 500 501 504 3707 3708 3709 3711 3713 3716 2567 13 498 813 
    
    4270 4271 4272 4273 4274 4275 4276 4277 4278 4279 4280 4281 4282 4283 4284 4285 4286 4287 4288 4289 4290 4291 4292 4293 4294 4295 4296 4297 4298 4299 4300 4301 4302 4303 4304 4305 4306 4307 4308 4309 4310 4311 4312 4313 4314 4315 4316 4317 4318 4319 4320 4321 4322 4323 4324 4325 4326 4327 4328 4329 4330 4331 4332 4333 4334 4335 4336 4337 4338 4339 4340 4341 4342 4343 4344 4345 4346 4347 4348 4349 4350 4351 4352 4353 4354 4355 4356 4357 4358 4359 4360 4361 4362 4363 4364 4365 4366 4367 4368 4369 4370 4371 4372 4373 4374 4375 4376 4377 4378 4379 4380 4381 4382 4383 4384 4385 4386 4387 4388 4389 4390 4391 4392 4393 4394 4395 4396 4397 4398 4399 4400 4401 4402 4403 4404 4405 4406
    
    144 103 4200 4189 114 139 4196 4197 78 62 4225 4190 4171 4195 4194 4185 4172 4199 4188 4170 4187 4198 4210 4229 4231 4203 4169 4228 4226 4202 4223 4201 143 141 4227 759
}

force_coastal = { }

definitions = "definition.csv"
provinces = "provinces.bmp"
positions = "positions.txt"
terrain = "terrain.bmp"
rivers = "rivers.bmp"
terrain_definition = "terrain.txt"
heightmap = "heightmap.bmp"
tree_definition = "trees.bmp"
continent = "continent.txt"
adjacencies = "adjacencies.csv"
climate = "climate.txt"
region = "region.txt"
superregion = "superregion.txt"
area = "area.txt"
provincegroup = "provincegroup.txt"
ambient_object = "ambient_object.txt"
seasons = "seasons.txt"
trade_winds = "trade_winds.txt"

# Define which indices in trees.bmp palette which should count as trees for automatic terrain assignment
tree = { 3 4 7 10 }
