blackrock_spawn = {
    1050 630 884 707 2180 994 2156 2155 2191
}

bleeding_hollow_spawn = {
    2171 814 869 836 853 2181 864 725 2176 938 2182 2161 921 2162
}

twilights_hammer_spawn = {
    1033 807 1043 553 1042 2174
}

shadow_council_spawn = {
    1035 1045 1034
}

twilight_hammer_draenei_holdings = {
    1706 1708 1707 1717 2058 1709 2057 1710
}

shadow_council_draenei_holdings = {
    2044 1648 1649 2047 1568 1642 1641 1658 1671 2037 1677 1669 1670 1679 1668 1667
}

scourge_homeland = {
    523 726 2374 2371 3256 2373 2372 2375 1268 1267 2368 2370 2367 1269 2366 827 2378 911 1226 2494 930 895 777 3258 3261 2376 3257 3259 3260
}

pg_uncolonizable = {
}

# Continent-specific
ek_lakes = {
    3627 3624 3625 3620 3621 3619 3618 3622 3616 3615 3614 3613 3610 3609 3608 3607 3605 3606 3599 3598 3597 3596 3604 3603 3602 3601 3617 3612 3611 3600 3623 
}

ek_wasteland = {
    1202 1204 1205 1203 1201 1200 1199 1198 1174 1195 1194 1196 1197 1173 1172 1193 1192 1191 1190 1189 1188 1187 1186 1183 1185 1184 1182 1181 1180 1179 1178 1177 1176 1175 1170 1171 1168 1169 1167 1166 1165 1162 1163 1164 1148 1150 1146 1145 1147 1149 1151 1152 1153 1154 1144 1155 1156 1157 1158 1160 1161 1143 1141 1066 1063 1030 1031 1036 1024 1023 987 980 977 972 1040 1049 1053 1059 1060 965 963 955 952 948 940 929 924 923 1159 1062
}

kalimdor_lakes = {
    3514 3516 3517 3515 3518 3523 3519 3520 3521 3522 3525 3524 3526 3528 3527 3529 3530 3532 3533 3534 3531 3536 3537 3535 3538 3540 3539 3541 3544 3542 3543 3548 3547 3546 3545 3551 3549 3550 3554 3552
}

kalimdor_wasteland = {
    1138 1139 3377 1481 1419 1479 1600 1501 1503 1826 2276 2257 3378 3379 3381 3376 3391 3390 3389 3386 3383 3384 3385 3387 3382 3392 3393 3394 3430 3431 3432 3433 1121 3388 2137 1640 508 1963 3071 1700 1096 1524 1425 1415 1414 1413 1411 368 1008 604 1660 2019 3380
} 

northrend_lakes = {
    3573 3572 3571 3570 3569 3568 3567 3566 3558 3557 3556 3555 3561 3565 3564 3563 3562 3559 3560 
}

northrend_wasteland = {
    745 738 719 718 699 700 709 694 678 689 684 675 674 668 670 666 665 667 657 658 654 647 
}

zandalar_lakes = {
    3581 3580 3579 
}

zandalar_wasteland = {
    754 758 759
}

broken_isles_lakes = {
    3577 3578 3574 3576 3575 
}

broken_isles_wasteland = {
    
}

south_sea_wasteland = {
    640
}

pandaria_lakes = {
    3584 3590 3587 3586 3585 3588 3589 3591 3593 3594 3595 3583 3582 3592 
}

pandaria_wasteland = {
    765 768 770 818 798 793 786 819 823 831 912 909 910 906 907 905 886 871 877 861 847 854 857 
}

draenor_lakes = {
    3743 3742 3744 3745 3746 3747 
}

draenor_wasteland = {
    3741 
}

outland_lakes = {
    3629 3628 3630 3631 3632 3633
}

outland_wasteland = {
    1223 1221 1220 1219 1218 1217 1215 1222 1216 1212 1213 1209 1210 1207 1211 1224 1230 1231
}

ocean_wasteland = {
    3720 3719 3718 3905
}

elemental_plane_wasteland = {

}

outland_void_wasteland = {
    3968
}

draenor_ocean_wasteland = {
    328
}


#-----------------------------------------------------
# Misc
#-----------------------------------------------------
# Scourge Missions
silver_hand_provinces = { 
    557 2187 2975 2175 2172 979 964 2020 591 646 662 2018 2017
}

argent_dawn_provinces = {
    2026 859 843 875 2970 2971 2972 2973 2974 2976 891 3074 778 2096 2124 574 557 1054 507 1922 729 932 2179 723 1921
}

scarlet_crusade_provinces = {
    1044 2025 979 964 2024 2023 2022 2021 775 3069 742 1923 703 722 805 821 2168 2027 2172 2175 2170 2975 2187 642 608 592 625 3075
}

risen_provinces = {
    642 2975 608 3075 625 592 2170 2175 2172 2168 2027 859 2026 2096 2124 2187 843
}

risen_forsaken_feee_provinces = {
    1011 1028 519 539
}