#--------------------------------------------------------
# Inaccessible Provinces
#--------------------------------------------------------
inaccessible_eastern_kingdoms = {
    3627 3624 3625 3620 3621 3619 3618 3622 3616 3615 3614 3613 3610 3609 3608 3607 3605 3606 3599 3598 3597 3596 3604 3603 3602 3601 3617 3612 3611 3600 3623 3008 923 924 929 940 955 963 965 972 948 977 980 987 1023 1024 1036 1031 1030 1040 1049 1053 1059 1060 1062 1063 1066 1141 1143 1146 1145 1147 1144 1149 1152 1151 1153 1155 1156 1158 1157 1159 1160 1161 1148 1150 1164 1163 1162 1166 1165 1167 1169 1168 1170 1172 1178 1179 1185 1182 1181 1195 1203 1202 952 1154 1200 3905 4208
}

inaccessible_kalimdor = {
    3514 3516 3517 3515 3518 3523 3519 3520 3521 3522 3525 3524 3526 3528 3527 3529 3530 3532 3533 3534 3531 3536 3537 3535 3538 3540 3539 3541 3544 3542 3543 3548 3547 3546 3545 3551 3549 3550 3554 3552 604 1138 1139 3377 1481 1419 1479 1600 1503 1501 1826 2276 3378 3379 3381 3376 3382 2257 3383 3385 3384 3386 3387 3388 3433 1121 3430 3432 3431 3394 3393 3392 3389 3390 3391 508 1963 3071 1700 1096 1524 1425 1414 1415 1413 1411 368 1660 1008 2019 1640 2137 3380 3722 3725 3740 3739 3476
} 

inaccessible_northrend = {
    3573 3572 3571 3570 3569 3568 3567 3566 3558 3557 3556 3555 3561 3565 3564 3563 3562 3559 3560 647 654 657 658 667 665 666 670 668 699 719 718 675 674 678 689 684 694 700 709 738 745 3726 4 3719
}

inaccessible_pandaria = {
    3584 3590 3587 3586 3585 3588 3589 3591 3593 3594 3595 3583 3582 3592 765 818 770 768 798 793 786 823 819 831 910 909 912 907 906 905 871 886 877 861 847 854 857 3718 3723
}

inaccessible_kul_tiras = {
    3717
}

inaccessible_zandalar = {
    3581 3580 3579 754 758 759 3717
}

inaccessible_broken_isles = {
    3577 3578 3574 3576 3575 
}

inaccessible_south_seas = {
    640 3722 3724 3725
}

inaccessible_plunder_isle = {
    3718 4766
}

inaccessible_nazjatar = {
    3726 3725
}

inaccessible_dragon_isles = {
    2800 128 147 935 2699 2560 2693 2567 2695 2694 2696 2697 2698 2692
}

inaccessible_draenor = {
    3743 3742 3744 3745 3746 3747 3741 328
}

inaccessible_outland = {
    3629 3628 3630 3631 3632 3633 1223 1221 1220 1219 1218 1217 1215 1222 1216 1212 1213 1209 1210 1207 1211 1224 1230 1231 1214 3968
}

inaccessible_skywall = {
    3738
}

inaccessible_abyssal_maw = {
    3083
}

inaccessible_firelands = {
    3084
}

inaccessible_deepholm = {
    3082
}

inaccessible_argus = {
    3737 2763 2762 2761
}

inaccessible_shadowlands = {
    3085 4840
}

inaccessible_ocean = {
    3720 3719 3718 3905
}

#-----------------------------------------------------
# Misc
#-----------------------------------------------------
# Scourge Missions
silver_hand_provinces = { 
    557 2187 2975 2175 2172 979 964 2020 591 646 662 2018 2017
}

argent_dawn_provinces = {
    2026 859 843 875 2970 2971 2972 2973 2974 2976 891 3074 778 2096 2124 574 557 1054 507 1922 729 932 2179 723 1921
}

scarlet_crusade_provinces = {
    1044 2025 979 964 2024 2023 2022 2021 775 3069 742 1923 703 722 805 821 2168 2027 2172 2175 2170 2975 2187 642 608 592 625 3075
}

risen_provinces = {
    642 2975 608 3075 625 592 2170 2175 2172 2168 2027 859 2026 2096 2124 2187 843
}

risen_forsaken_feee_provinces = {
    1011 1028 519 539
}

blackrock_spawn = {
    1050 630 884 707 2180 994 2156 2155 2191
}

bleeding_hollow_spawn = {
    2171 814 869 836 853 2181 864 725 2176 938 2182 2161 921 2162
}

twilights_hammer_spawn = {
    1033 807 1043 553 1042 2174
}

shadow_council_spawn = {
    1035 1045 1034
}

twilight_hammer_draenei_holdings = {
    1706 1708 1707 1717 2058 1709 2057 1710
}

shadow_council_draenei_holdings = {
    2044 1648 1649 2047 1568 1642 1641 1658 1671 2037 1677 1669 1670 1679 1668 1667
}

scourge_homeland = {
    523 726 2374 2371 3256 2373 2372 2375 1268 1267 2368 2370 2367 1269 2366 827 2378 911 1226 2494 930 895 777 3258 3261 2376 3257 3259 3260
}
